key	en
year	year
BCE	BCE
CE	CE
Adam	Adam
Seth	Seth
Enosh	Eʹnosh
Kenan	Keʹnan
Mahalalel	Ma·halʹa·lel
Jared	Jaʹred
Enoch	Eʹnoch
Methuselah	Me·thuʹse·lah
Lamech	Laʹmech
Noah	Noah
Shem	Shem
Arpachshad	Ar·pachʹshad
Shelah	Sheʹlah
Eber	Eʹber
Peleg	Peʹleg
Reu	Reʹu
Serug	Seʹrug
Nahor	Naʹhor
Terah	Teʹrah
Abraham	Abraham
Isaac	Isaac
Jacob	Jacob
Joseph	Joseph
Moses	Moses
